#########################
#   ###############     #
#                       #
# $#################.####
## ######################
##                      #
####################### #
#@                      #
#########################
