#######
#  @  #
#  $  #
#  $  #
#     #
##NN###
 #NN#
 #11######
 #NNWWW..#
#WNWWWW  #
#SSS###  #
##### ####