#########
#@R   R.#
#RRR   $#
# ####  #
###  ####