#########
###d#dR@#
#dRRR d##
##$     #
 # ######
 #D#
 #D#
 #.#
 ###