###### ####
#    ###  #
#@$$$     #
#     ### #
## #### # #
 # #    # #
 #2#    #1#
## #### # ##
#     ###  #
# ...      #
############