##############
#@$ X##.Y  X #
#    ####R   #
####T## #    #
   ### Y#T####
     ######