   ######
####    #
#  * $  #
#  +    #
#  . $  #
#########