####
# @#
# $#
# a#
#  #
#AA#
#  ######
#     B.#
#     #####
#  R    ab#
###########