###########

#.     $  #

########  #

#@        #

###########
